[
    {
        "tileSize": 36,
        "waiterSpeed": 1.8,
        "enemySpeed": 1.0,
        "waiterStart": {"x": 1.5, "y": 1.5},
        "enemies": [
            {"x": 9.5, "y": 7.5, "color": "red", "dir": "up"},
            {"x": 11.5, "y": 7.5, "color": "yellow", "dir": "right"}
        ],
        "map": [
            [1,1,1,1,1,1,1,1,1,1,1,1,1,1,1,1,1,1,1,1,1],
            [1,0,0,0,0,0,0,0,0,0,1,0,0,0,0,0,0,0,0,0,1],
            [1,0,1,1,1,0,1,1,1,0,1,0,1,1,1,0,1,1,1,0,1],
            [1,0,0,0,0,0,1,0,0,0,0,0,0,0,1,0,0,0,0,0,1],
            [1,0,1,1,1,0,1,0,1,1,1,1,1,0,1,0,1,1,1,0,1],
            [1,0,0,0,0,0,0,0,0,0,1,0,0,0,0,0,0,0,0,0,1],
            [1,1,1,1,1,0,1,1,1,2,2,2,1,1,1,0,1,1,1,1,1],
            [1,0,0,0,0,0,1,0,0,2,2,2,0,0,1,0,0,0,0,0,1],
            [1,0,1,1,1,0,1,0,1,1,1,1,1,0,1,0,1,1,1,0,1],
            [1,0,0,0,1,0,0,0,0,0,1,0,0,0,0,0,1,0,0,0,1],
            [1,1,1,0,1,0,1,1,1,0,1,0,1,1,1,0,1,0,1,1,1],
            [1,0,0,0,0,0,0,0,0,0,0,0,0,0,0,0,0,0,0,0,1],
            [1,1,1,1,1,1,1,1,1,1,1,1,1,1,1,1,1,1,1,1,1]
        ]
    },
    {
        "tileSize": 30,
        "waiterSpeed": 1.5,
        "enemySpeed": 0.85,
        "waiterStart": {"x": 1.5, "y": 1.5},
        "enemies": [
            {"x": 11.5, "y": 7.5, "color": "red", "dir": "up"},
            {"x": 12.5, "y": 7.5, "color": "yellow", "dir": "left"},
            {"x": 13.5, "y": 7.5, "color": "purple", "dir": "right"}
        ],
        "map": [
            [1,1,1,1,1,1,1,1,1,1,1,1,1,1,1,1,1,1,1,1,1,1,1,1,1],
            [1,0,0,0,0,0,0,0,0,0,0,0,1,0,0,0,0,0,0,0,0,0,0,0,1],
            [1,0,1,1,1,1,0,1,1,1,1,0,1,0,1,1,1,1,0,1,1,1,1,0,1],
            [1,0,1,1,1,1,0,1,1,1,1,0,1,0,1,1,1,1,0,1,1,1,1,0,1],
            [1,0,0,0,0,0,0,0,0,0,0,0,0,0,0,0,0,0,0,0,0,0,0,0,1],
            [1,0,1,1,1,1,0,1,0,1,1,1,1,1,1,1,0,1,0,1,1,1,1,0,1],
            [1,0,0,0,0,0,0,1,0,0,0,0,1,0,0,0,0,1,0,0,0,0,0,0,1],
            [1,1,1,1,1,1,0,1,1,1,1,2,2,2,1,1,1,1,0,1,1,1,1,1,1],
            [1,0,0,0,0,0,0,1,0,0,0,2,2,2,0,0,0,1,0,0,0,0,0,0,1],
            [1,0,1,1,1,1,0,1,0,1,1,1,1,1,1,1,0,1,0,1,1,1,1,0,1],
            [1,0,0,0,0,1,0,0,0,0,0,0,1,0,0,0,0,0,0,1,0,0,0,0,1],
            [1,1,1,1,0,1,0,1,1,1,1,0,1,0,1,1,1,1,0,1,0,1,1,1,1],
            [1,0,0,0,0,0,0,0,0,0,0,0,0,0,0,0,0,0,0,0,0,0,0,0,1],
            [1,0,1,1,1,1,1,1,1,1,1,1,1,1,1,1,1,1,1,1,1,1,1,0,1],
            [1,1,1,1,1,1,1,1,1,1,1,1,1,1,1,1,1,1,1,1,1,1,1,1,1]
        ]
    },
    {
        "tileSize": 32, 
        "waiterSpeed": 1.6,
        "enemySpeed": 1.0,
        "waiterStart": {"x": 1.5, "y": 1.5},
        "enemies": [
            {"x": 13.5, "y": 8.5, "color": "red", "dir": "up"},
            {"x": 14.5, "y": 8.5, "color": "yellow", "dir": "left"},
            {"x": 15.5, "y": 8.5, "color": "purple", "dir": "right"},
            {"x": 16.5, "y": 8.5, "color": "blue", "dir": "down"}
        ],
        "map": [
            [1,1,1,1,1,1,1,1,1,1,1,1,1,1,1,1,1,1,1,1,1,1,1,1,1,1,1,1,1,1,1],
            [1,0,0,0,0,0,0,0,0,0,0,0,0,0,0,1,0,0,0,0,0,0,0,0,0,0,0,0,0,0,1],
            [1,0,1,1,1,1,1,0,1,1,1,1,1,1,0,1,0,1,1,1,1,1,1,0,1,1,1,1,1,0,1],
            [1,0,0,0,0,0,0,0,0,0,0,0,0,0,0,0,0,0,0,0,0,0,0,0,0,0,0,0,0,0,1],
            [1,0,1,1,1,1,1,0,1,1,0,1,1,1,1,1,1,1,1,0,1,1,0,1,1,1,1,1,1,0,1],
            [1,0,0,0,0,0,0,0,1,1,0,0,0,0,0,1,0,0,0,0,1,1,0,0,0,0,0,0,0,0,1],
            [1,1,1,1,1,1,1,0,1,1,1,1,1,1,0,1,0,1,1,1,1,1,1,0,1,1,1,1,1,1,1],
            [1,0,0,0,0,0,0,0,1,1,0,0,0,0,0,0,0,0,0,0,1,1,0,0,0,0,0,0,0,0,1],
            [1,0,1,1,1,1,1,0,1,1,0,1,1,2,2,2,2,2,1,0,1,1,0,1,1,1,1,1,1,0,1],
            [1,0,1,1,1,1,1,0,0,0,0,1,1,2,2,2,2,2,1,0,0,0,0,1,1,1,1,1,1,0,1],
            [1,0,0,0,0,0,0,0,1,1,0,1,1,1,1,1,1,1,1,0,1,1,0,0,0,0,0,0,0,0,1],
            [1,1,1,1,1,1,1,0,1,1,0,0,0,0,0,1,0,0,0,0,1,1,0,1,1,1,1,1,1,1,1],
            [1,0,0,0,0,0,0,0,0,0,0,1,1,1,0,1,0,1,1,1,0,0,0,0,0,0,0,0,0,0,1],
            [1,0,1,1,1,1,1,1,1,1,0,1,1,1,0,1,0,1,1,1,0,1,1,1,1,1,1,1,1,0,1],
            [1,0,0,0,0,0,0,0,0,0,0,0,0,0,0,0,0,0,0,0,0,0,0,0,0,0,0,0,0,0,1],
            [1,1,1,1,1,1,1,1,1,1,1,1,1,1,1,1,1,1,1,1,1,1,1,1,1,1,1,1,1,1,1]
        ]
    }
]